0 S T T T T T T T T 0 S T T T T T T T T 0 S T T T T T T T T 0 S T T T T T T T T
0 X 0 T T T T T T T 0 X 0 T T T T T T T 0 X 0 T T T T T T T 0 X 0 T T T T T T T
0 X 0 0 T T T T T T 0 X 0 0 T T T T T T 0 X 0 0 T T T T T T 0 X 0 0 T T T T T T
0 X 0 0 0 0 0 0 0 T 0 X 0 0 0 0 0 0 0 T 0 X 0 0 0 0 0 0 0 T 0 X 0 0 0 0 0 0 0 T
0 X X X X X X X 0 0 0 X X X X X X X 0 0 0 X X X X X X X 0 0 0 X X X X X X X 0 0
0 0 0 0 0 0 0 X 0 0 0 0 0 0 0 0 0 X 0 0 0 0 0 0 0 0 0 X 0 0 0 0 0 0 0 0 0 X 0 0
T 0 0 0 0 0 0 X 0 0 T 0 0 0 0 0 0 X 0 0 T 0 0 0 0 0 0 X 0 0 T 0 0 0 0 0 0 X 0 0
T T 0 0 0 0 0 X 0 0 T T 0 0 0 0 0 X 0 0 T T 0 0 0 0 0 X 0 0 T T 0 0 0 0 0 X 0 0
T T T T 0 0 0 X 0 0 T T T T 0 0 0 X 0 0 T T T T 0 0 0 X 0 0 T T T T 0 0 0 X 0 0
T T T T T 0 0 E 0 0 T T T T T 0 0 E 0 0 T T T T T 0 0 E 0 0 T T T T T 0 0 E 0 0
0 S T T T T T T T T 0 S T T T T T T T T 0 S T T T T T T T T 0 S T T T T T T T T
0 X 0 T T T T T T T 0 X 0 T T T T T T T 0 X 0 T T T T T T T 0 X 0 T T T T T T T
0 X 0 0 T T T T T T 0 X 0 0 T T T T T T 0 X 0 0 T T T T T T 0 X 0 0 T T T T T T
0 X 0 0 0 0 0 0 0 T 0 X 0 0 0 0 0 0 0 T 0 X 0 0 0 0 0 0 0 T 0 X 0 0 0 0 0 0 0 T
0 X X X X X X X 0 0 0 X X X X X X X 0 0 0 X X X X X X X 0 0 0 X X X X X X X 0 0
0 0 0 0 0 0 0 X 0 0 0 0 0 0 0 0 0 X 0 0 0 0 0 0 0 0 0 X 0 0 0 0 0 0 0 0 0 X 0 0
T 0 0 0 0 0 0 X 0 0 T 0 0 0 0 0 0 X 0 0 T 0 0 0 0 0 0 X 0 0 T 0 0 0 0 0 0 X 0 0
T T 0 0 0 0 0 X 0 0 T T 0 0 0 0 0 X 0 0 T T 0 0 0 0 0 X 0 0 T T 0 0 0 0 0 X 0 0
T T T T 0 0 0 X 0 0 T T T T 0 0 0 X 0 0 T T T T 0 0 0 X 0 0 T T T T 0 0 0 X 0 0
T T T T T 0 0 E 0 0 T T T T T 0 0 E 0 0 T T T T T 0 0 E 0 0 T T T T T 0 0 E 0 0
0 S T T T T T T T T 0 S T T T T T T T T 0 S T T T T T T T T 0 S T T T T T T T T
0 X 0 T T T T T T T 0 X 0 T T T T T T T 0 X 0 T T T T T T T 0 X 0 T T T T T T T
0 X 0 0 T T T T T T 0 X 0 0 T T T T T T 0 X 0 0 T T T T T T 0 X 0 0 T T T T T T
0 X 0 0 0 0 0 0 0 T 0 X 0 0 0 0 0 0 0 T 0 X 0 0 0 0 0 0 0 T 0 X 0 0 0 0 0 0 0 T
0 X X X X X X X 0 0 0 X X X X X X X 0 0 0 X X X X X X X 0 0 0 X X X X X X X 0 0
0 0 0 0 0 0 0 X 0 0 0 0 0 0 0 0 0 X 0 0 0 0 0 0 0 0 0 X 0 0 0 0 0 0 0 0 0 X 0 0
T 0 0 0 0 0 0 X 0 0 T 0 0 0 0 0 0 X 0 0 T 0 0 0 0 0 0 X 0 0 T 0 0 0 0 0 0 X 0 0
T T 0 0 0 0 0 X 0 0 T T 0 0 0 0 0 X 0 0 T T 0 0 0 0 0 X 0 0 T T 0 0 0 0 0 X 0 0
T T T T 0 0 0 X 0 0 T T T T 0 0 0 X 0 0 T T T T 0 0 0 X 0 0 T T T T 0 0 0 X 0 0
T T T T T 0 0 E 0 0 T T T T T 0 0 E 0 0 T T T T T 0 0 E 0 0 T T T T T 0 0 E 0 0
0 S T T T T T T T T 0 S T T T T T T T T 0 S T T T T T T T T 0 S T T T T T T T T
0 X 0 T T T T T T T 0 X 0 T T T T T T T 0 X 0 T T T T T T T 0 X 0 T T T T T T T
0 X 0 0 T T T T T T 0 X 0 0 T T T T T T 0 X 0 0 T T T T T T 0 X 0 0 T T T T T T
0 X 0 0 0 0 0 0 0 T 0 X 0 0 0 0 0 0 0 T 0 X 0 0 0 0 0 0 0 T 0 X 0 0 0 0 0 0 0 T
0 X X X X X X X 0 0 0 X X X X X X X 0 0 0 X X X X X X X 0 0 0 X X X X X X X 0 0
0 0 0 0 0 0 0 X 0 0 0 0 0 0 0 0 0 X 0 0 0 0 0 0 0 0 0 X 0 0 0 0 0 0 0 0 0 X 0 0
T 0 0 0 0 0 0 X 0 0 T 0 0 0 0 0 0 X 0 0 T 0 0 0 0 0 0 X 0 0 T 0 0 0 0 0 0 X 0 0
T T 0 0 0 0 0 X 0 0 T T 0 0 0 0 0 X 0 0 T T 0 0 0 0 0 X 0 0 T T 0 0 0 0 0 X 0 0
T T T T 0 0 0 X 0 0 T T T T 0 0 0 X 0 0 T T T T 0 0 0 X 0 0 T T T T 0 0 0 X 0 0
T T T T T 0 0 E 0 0 T T T T T 0 0 E 0 0 T T T T T 0 0 E 0 0 T T T T T 0 0 E 0 0
